1/1/2/2/2/2/2/1
2/2/2/1/1/1/2/1
2/5/3/4/1/1/2/1
2/2/2/1/4/5/2/1
2/5/2/2/4/1/2/1
2/1/2/1/5/1/2/2
2/4/1/6/4/4/5/2
2/1/1/1/5/1/1/2
2/2/2/2/2/2/2/2